#########################################################################
#                                                                       #
#                                                                       #
#                                                                       #
#                                                                       #
#        #####################                                          #
#        #                   #                                          #
#        #                   #                                          #
#        #                   #                                          #
#        #                   #                                          #
#        #                   #                                          #
#        #                   #                                          #
#        #                   #                                          #
#        #####################                                          #
#                                                                       #
#                                                                       #
#                                                                       #
#                                                                       #
#                                                                       #
#                                                                       #
#                                                                       #
#                                                                       #
# X #####################################################################